primira matrix:
10 10
0 0 2 0 0 0 0 0 0 0
0 0 1 0 0 0 0 1 0 0
0 0 1 1 0 0 0 1 0 0
0 0 0 1 1 1 1 1 1 0
0 0 0 1 0 1 0 0 0 0
0 0 1 1 0 0 0 0 0 0
0 0 1 0 0 0 0 1 1 2
0 0 1 1 0 0 0 1 0 0
0 0 0 1 1 1 1 1 1 0
0 0 0 3 0 4 0 0 0 0

Segunda matrix:
12 21
0 0 0 0 0 0 0 0 0 0 0 0 0 0 0 0 1 0 0 0 0
0 1 4 1 1 1 1 0 1 0 1 1 1 1 1 1 1 0 1 0 0
0 1 0 0 1 0 1 0 1 0 1 0 0 0 1 0 0 1 1 1 0
0 1 1 0 1 0 1 1 1 1 1 1 1 0 1 1 0 1 0 1 0
0 0 1 0 1 0 0 1 0 0 0 0 1 0 0 1 1 1 0 0 0
0 1 1 0 0 0 1 1 1 1 1 1 0 1 1 1 0 1 0 1 0
0 1 0 0 1 0 0 1 0 1 0 1 0 0 1 0 1 1 1 1 0
0 1 1 1 1 1 0 1 0 0 0 1 0 0 1 0 1 0 1 0 0
0 1 0 1 0 1 1 1 1 1 1 1 1 1 1 1 1 1 0 0 0
0 2 1 1 0 1 0 1 0 0 0 1 0 0 1 0 0 1 0 1 0
0 1 0 1 1 1 0 1 1 1 1 1 0 1 1 0 1 1 1 1 2
0 0 0 0 0 0 0 0 0 0 0 0 0 0 0 0 0 0 0 0 0